4 | D . X . P
3 | . . X . .
2 | . . X . .
1 | . . . . .
0 | R . . . .
  +----------
    0 1 2 3 4
