4 | D . P . P
3 | . . X . .
2 | . . X . .
1 | . . X . .
0 | R . X . .
  +----------
    0 1 2 3 4
